RAJIV	S
RACHEE	A
PRATHMESH	S
OnlineMeet	O
UDIT	S
CHANDRASEKAR	A
SUMITH	S
KEDAR	S
RAJ	A
DINESH	A
SANTOSH	A
OnlineMeet	O
PAVAN	S
KARTIK	S
ANURAG	S
ARSHDEEP A
DEEPAK	S
OnlineMeet	O
KUNAL	A
NIKHIL	S
